*...................*
.........#.#.........
.........#.#.........
.........#.#.........
.........#.#.........
.........#.#.........
.........#.#.........
......####.####......
......#.......#......
.######.......######.
..........@..........
.######.......######.
......#.......#......
......####.####......
.........#.#.........
.........#.#.........
.........#.#.........
.........#.#.........
.........#.#.........
*...................*
