*...................*
.........#.#.........
.........#.#.........
.........#.#.........
.........#.#.........
.........#.#.........
.........#.#.........
*.....####.####.....*
~~~~~~#.......#~~~~~~
#~#~#~#..@@@..#~#~#~#
.........@@@.........
.........@@@.........
~#~#~##..@@@..##~#~#~
~~~~~~#.......#~~~~~~
~~~~~~####.####~~~~~~
~~~~~~~~~#.#~~~~~~~~~
~~~~~~~~~#.#~~~~~~~~~
~~~~~~~~~#.#~~~~~~~~~
~~~~~~~~~#.#~~~~~~~~~
~~~~~~~~~#.#~~~~~~~~~
~~~~~~~~~#.#~~~~~~~~~
