@........*
..........
..######..
..#....#..
..#....#..
..#....#..
..#....#..
..##..##..
..........
*........*
