...............................................................................
...............................................................................
...*******.....................................................................
.....*******...........................................................~~~.....
.........................................#########....................~~~~.....
.........................................#~~~~~~~....................~~~~~.....
.........................................#~~~~~~~...................~~~~~~~....
...~~~~~~~...............................#~~~~~~~~~......###.###.....~~~~......
.....~~~~~~~............#.#................~~~~~~~~~~....#.....#...............
........................#.#..................~~~~~~......#.....#...............
#########################.################################.###.################
........................#.#.................................#..................
........................#.#.................................#..................
........................#.#.........######################################.....
....~~~~~~~~~~~.....................#..........................................
....~~~~~~~~~~~.@...................#..........................................
....~~~~~~~~~~~.....................#..............~~~~~~......................
....................................#..............~~~~~~......................
......................~~~...........#.......~~~~~~~~~~~~~~.....................
..................~~~~~~~...........#........~~~~~~~~~~~~~.....................
..................~~~~~~~...........#................###########...............
..........................................................@....................
...............................................................................
.....................................................###########...............
