...#########################################################################
...#**.............**...#.......................#..#......@@......#..#...@@#
...#**#######..####**##########..#..####..#..####..#######@@#..####..####@@#
......#.....#..#........#.....#..#..#..#..#..#........#.....#..#..#..#..#..#
##########..#..#######..#..#..#######..####..####..##########..#..#..#..#..#
#.....#........#..#.....#..#..#........#..#..#.....#........#..#..#..#.....#
####..####..####..####..####..####..####..#..#..#######..####..#..#..#..####
#.....#.....#..........................#..............#..#..#........#.....#
####..#######..####..#..#############..#..####..#######..#..#######..#..#..#
#.....#..#........#..#..#.....#.....#..#..#..#.....#..#..#..#..#.....#..#..#
####..#..####..##########..#..#..#..#..####..#..####..#..#..#..####..#..####
#..#..#........#..#........#..#..#..#.....#.....#..#..#..#..#.....#.....#..#
#..#..##########..#######..####..#######..####..#..#..#..#..#..#######..#..#
#..#.....#........#..#..#.....#..#........#..#..#..............#..#........#
#..#..##########..#..#..#..####..#######..#..#..####..#..####..#..####..####
#........#..........................#..#..#.....#..#..#..#........#........#
####..##########..####..#..#######..#..#..#..####..#..####..#..#..####..####
#...........#.....#.....#..#..#.....#..#.....#.....#..#.....#..#..#.....#..#
#..#..#..#############..####..####..#..####..####..##########..#######..#..#
#..#..#...........#..#..#....................#...........#..#........#.....#
#..#..####..####..#..#######..#..##########..#..##########..#..#..####..#..#
#..#..#.....#.....#........#..#..#..#..............#..#..#..#..#.....#..#..#
#..#############..####..##########..#######..####..#..#..#..####..####..####
#..#.....#.................#.....#..#.....#..#.....#........#........#.....#
####..####..#..#..#..#..#######..#..####..####..####..##########..####..#..#
#........#..#..#..#..#..#..#..#.....#.....#........#...........#........#..#
####..#..#..####..####..#..#..####..####..#######..#..##########..##########
#.....#..#..#.....#....................#..#.................#..#.....#.....#
####..#..#..##########..#..#######..#..#..##########..#######..#..####..####
#.....#..#..#........#..#..#.....#..#..#..#.....#..#.....#........#.....#..#
#..#..#..##########..#..#######..####..#..####..#..####..#######..#..####..#
#..#..#..#..#...........#.....#..............#........#....................#
#######..#..#######..#..####..#..#######..#######..################..#..#..#
#..#..#..............#.....#..#..#.................#.................#..#..#
#..#..#..#..#..#..##########..####..#..#..#..####..##########..####..#######
#..#..#..#..#..#..#..............#..#..#..#..#.................#...........#
#..#..######################..####..################..####..##########..####
#.....#.....#...........#..#..#.....#........#..#........#.....#..#..#.....#
####..#..##########..####..#..##########..#..#..####..##########..#..#..####
#........#...........#.....#.....#........#..#..#..#..#..#...........#.....#
#######..#..####..#..#..####..#..#######..####..#..####..##########..#..####
#..#...........#..#........#..#..............#..............#...........#..#
#..####..#..#######..#..#######..#######..#..#############..#######..####..#
#........#..#........#..............#.....#..#..#..#..#....................#
#..#..####..#..#######..#..################..#..#..#..#######..####..####..#
#..#.....#..#.....#.....#..#......................................#..#.....#
#..#..#######..#######..#..####..#######..#######..#..#..#..#############..#
#..#.....#.....#..#.....#..#........#..#..#........#..#..#..#..#.....#..#..#
#..#..####..#..#..####..#######..#..#..#######..#######..####..####..#..#..#
#..#..#.....#.....#........#.....#..#.................#..#.................#
############################################################################
