@........*
..........
..#~~~~#..
..#....#..
..#....#..
..#....#..
..#....#..
..##..##..
..........
*........@
